18 18 18 18 18 18 18 18 18 18 18 18 18 18 18 18 18 18 18 18 18 18 18 18 18 18 18 18 18 18 18 18 18 18 18 18 18 18 18 18 18 18 18 18 18 18 18 18 18 18 
18 18 18 18 18 18 18 18 18 18 18 18 18 18 18 18 18 18 18 18 18 18 18 18 18 18 18 18 18 18 18 18 18 18 18 18 18 18 18 18 18 18 18 18 18 18 18 18 18 18 
18 18 18 18 18 18 18 18 18 18 18 18 18 18 18 18 18 18 18 18 18 18 18 18 18 18 18 18 18 18 18 18 18 18 18 18 18 18 18 18 18 18 18 18 18 18 18 18 18 18 
18 18 18 18 18 18 18 18 18 18 18 18 18 18 18 18 18 18 18 18 18 18 18 18 18 18 18 18 18 18 18 18 18 18 18 18 18 18 18 18 18 18 18 18 18 18 18 18 18 18 
18 18 18 18 18 18 18 18 18 18 18 18 18 18 18 18 18 18 18 18 18 18 18 18 18 18 18 18 18 18 18 18 18 18 18 18 18 18 18 18 18 18 18 18 18 18 18 18 18 18 
18 18 18 18 18 18 18 18 18 18 18 18 18 18 18 18 18 18 18 18 18 18 18 18 18 18 18 30 31 18 18 18 18 18 18 18 18 18 18 18 18 18 18 18 18 18 18 18 18 18 
18 18 18 18 18 18 18 18 18 18 18 18 18 18 18 18 18 18 18 18 18 18 18 18 18 18 18 18 18 18 18 18 18 18 18 18 18 18 18 18 18 18 18 18 18 18 18 18 18 18 
18 18 18 18 18 18 18 18 18 18 18 18 18 18 18 18 18 18 18 18 18 18 18 18 18 18 18 18 18 18 18 18 18 18 18 18 18 18 18 18 18 18 18 18 18 18 18 18 18 18 
18 18 18 18 18 18 18 18 18 28 26 26 26 26 26 26 26 26 26 26 26 26 26 26 26 26 26 26 26 26 26 26 26 26 26 26 26 26 26 26 26 26 29 18 18 18 18 18 18 18 
18 18 18 18 18 18 18 18 18 24 1 1 1 1 1 1 1 1 1 1 1 20 21 21 21 21 21 21 21 21 21 22 1 16 16 16 16 16 16 16 16 16 23 18 18 18 18 18 18 18 
18 18 18 18 18 18 18 18 18 24 1 16 16 16 16 16 16 16 16 1 1 23 18 19 18 28 29 18 18 28 29 24 1 16 16 16 16 16 16 16 16 16 23 18 18 18 18 18 18 18 
18 18 18 18 18 18 18 18 18 24 1 16 16 16 16 16 16 16 16 16 1 23 18 18 18 30 31 18 18 30 31 24 1 12 10 10 10 10 10 10 10 13 23 18 18 18 18 18 18 18 
18 18 18 18 18 18 18 18 18 24 1 16 16 16 16 16 16 16 16 16 1 23 28 29 18 18 18 19 18 18 18 24 1 8 3 3 3 3 3 3 3 7 23 18 18 18 18 18 18 18 
18 18 18 18 18 18 18 18 18 24 1 16 16 16 16 16 16 16 16 16 1 23 30 31 18 19 18 18 28 29 18 24 1 8 3 3 3 3 3 3 3 7 23 18 18 18 18 18 18 18 
18 18 18 18 18 18 18 18 18 24 1 16 16 16 16 16 16 16 16 16 1 23 19 18 18 18 18 18 30 31 19 24 1 8 3 3 3 3 3 3 3 7 23 18 18 18 18 18 18 18 
18 18 18 18 18 18 18 18 18 24 1 16 16 16 16 16 16 16 16 16 1 25 26 26 26 26 26 26 26 26 26 27 1 8 3 3 3 3 3 3 3 7 23 18 18 18 18 18 18 18 
18 18 18 18 18 18 18 18 18 24 1 16 16 16 16 16 16 16 16 1 1 1 1 1 1 1 1 1 1 1 1 1 1 8 3 3 3 3 3 3 3 7 23 18 18 18 18 18 18 18 
18 18 18 18 18 18 18 18 18 24 1 1 1 1 16 16 16 16 16 16 16 1 12 10 10 10 10 10 10 10 10 10 13 14 5 5 5 5 5 5 5 15 23 18 18 18 18 18 18 18 
18 18 18 18 18 18 18 18 18 24 1 1 1 1 16 16 16 16 16 16 1 1 8 3 3 3 3 3 3 3 3 3 7 1 16 1 1 1 1 1 1 1 23 18 18 18 18 18 18 18 
18 18 18 18 18 18 18 18 18 24 1 33 1 1 1 1 1 1 16 16 16 16 8 3 3 3 3 3 3 3 3 3 7 1 1 1 1 16 1 1 16 1 23 18 18 18 18 18 18 18 
18 18 18 18 18 18 18 18 18 24 1 1 1 1 33 1 1 1 16 16 16 16 8 3 3 3 3 3 3 3 3 3 7 16 16 16 16 16 16 16 1 1 23 18 18 18 18 18 18 18 
18 18 18 18 18 18 18 18 18 24 1 32 32 32 32 32 32 1 1 1 16 1 8 3 3 3 3 3 3 3 3 3 7 16 16 16 16 16 16 16 16 1 23 18 18 18 18 18 18 18 
18 18 18 18 18 18 18 18 18 24 1 1 12 10 10 10 10 10 10 10 10 10 11 3 3 3 3 3 3 3 3 3 7 16 16 16 16 16 16 16 16 1 23 18 18 18 18 18 18 18 
18 18 18 18 18 18 18 18 18 24 16 16 8 3 3 3 3 3 3 3 3 3 3 3 3 3 3 3 3 3 3 4 15 16 16 16 16 16 16 16 16 1 23 18 18 18 18 18 18 18 
18 18 18 18 18 18 18 18 18 24 1 1 8 3 3 3 3 3 3 3 3 3 3 3 3 3 3 3 3 3 3 7 16 16 16 16 16 16 16 16 16 1 23 18 18 18 18 18 18 18 
18 18 18 18 18 18 18 18 18 24 1 1 8 3 3 3 3 3 3 3 3 3 3 3 3 3 3 3 3 3 3 7 16 16 16 16 16 16 16 16 16 1 23 18 18 18 18 18 18 18 
18 18 18 18 18 18 18 18 18 24 1 16 8 3 3 3 3 3 3 3 3 3 3 3 3 3 3 3 3 3 3 7 16 16 16 16 16 16 16 16 16 1 23 18 18 18 18 18 18 18 
18 18 18 18 18 18 18 18 18 24 1 1 8 3 3 3 3 3 3 3 3 3 3 3 3 3 4 5 5 5 5 15 16 16 16 16 16 16 1 1 1 1 23 18 18 18 18 18 18 18 
18 18 18 18 18 18 18 18 18 24 16 16 8 3 3 3 3 3 3 3 3 3 3 3 3 3 7 1 1 1 16 16 16 16 1 1 1 1 1 1 1 1 23 18 18 18 18 18 18 18 
18 18 18 18 18 18 18 18 18 24 1 1 8 3 3 3 3 3 3 3 3 3 3 3 3 3 7 1 16 16 16 16 16 16 1 20 21 21 21 21 22 1 23 18 18 18 18 18 18 18 
18 18 18 18 18 18 18 18 18 24 1 12 11 3 3 3 3 3 3 3 3 3 3 4 5 5 15 1 1 1 1 1 1 1 1 23 18 18 18 18 24 1 23 18 18 18 18 18 18 18 
18 18 18 18 18 28 26 26 26 27 1 8 3 3 3 3 3 3 3 3 3 3 4 1 1 12 10 10 10 10 13 16 1 20 21 31 18 18 18 18 24 1 25 26 26 26 29 18 18 18 
18 18 18 18 18 24 12 10 10 10 10 11 3 3 3 3 3 3 3 3 3 4 12 10 10 11 3 3 3 3 7 1 1 23 18 18 18 18 18 18 24 1 16 1 1 1 23 18 18 18 
18 18 18 18 18 24 8 3 3 3 3 3 3 3 3 3 3 3 3 3 3 7 8 3 3 3 3 3 3 3 7 20 21 31 18 18 18 18 18 18 24 1 1 1 1 16 23 18 18 18 
18 18 18 18 18 24 8 3 3 3 3 3 3 3 3 3 3 3 3 3 3 7 14 6 3 3 3 3 3 3 7 23 18 18 18 18 18 18 18 18 24 1 16 16 16 1 23 18 18 18 
18 18 18 18 18 24 8 3 3 3 3 3 3 3 3 3 3 3 3 3 3 7 1 8 3 3 3 3 3 3 7 23 18 18 18 18 18 18 18 18 24 1 2 16 16 1 23 18 18 18 
18 18 18 18 18 24 8 3 3 3 3 3 3 3 3 3 3 3 3 3 3 7 16 8 3 3 3 3 3 3 7 25 26 29 18 18 18 18 18 18 24 1 2 2 2 2 23 18 18 18 
18 18 18 18 18 24 8 3 3 3 3 3 3 3 3 3 3 3 3 3 3 7 1 14 5 5 5 5 5 5 15 1 1 25 26 26 26 26 26 26 27 1 2 2 16 1 23 18 18 18 
18 18 18 18 18 24 1 6 3 3 3 3 3 3 3 3 3 3 3 3 4 15 1 12 10 10 10 10 13 1 1 1 1 1 1 16 16 16 16 16 16 16 1 1 1 1 23 18 18 18
18 18 18 18 18 24 1 33 6 3 3 3 3 3 3 3 3 3 3 4 1 16 1 11 3 3 3 3 9 13 16 16 16 16 1 1 1 1 1 1 1 1 1 1 16 1 23 18 18 18
18 18 18 18 18 30 22 1 14 5 16 5 5 5 5 5 5 5 5 12 10 10 11 3 3 3 3 3 3 9 10 10 13 16 1 16 16 16 16 16 16 16 16 1 16 1 23 18 18 18 
18 18 18 18 18 18 30 21 21 21 21 21 21 21 21 21 21 22 1 8 3 3 3 3 3 3 3 3 3 3 3 3 7 1 20 21 21 21 21 21 21 21 21 21 21 21 31 18 18 18 
18 18 18 18 18 18 18 18 18 18 18 18 18 18 18 18 18 24 1 8 3 3 3 3 3 3 3 3 3 3 3 3 7 1 23 18 18 18 18 18 18 18 18 18 18 18 18 18 18 18 
18 18 18 18 18 18 18 18 18 18 18 18 18 18 18 18 18 24 1 8 3 3 3 3 3 3 3 3 3 3 3 3 7 16 23 18 18 18 18 18 18 18 18 18 18 18 18 18 18 18 
18 18 18 18 18 18 18 18 18 18 18 18 18 18 18 18 18 24 16 16 6 3 3 3 3 3 3 3 3 3 3 3 7 1 23 18 18 18 18 18 18 18 18 18 18 18 18 18 18 18 
18 18 18 18 18 18 18 18 18 18 18 18 18 18 18 18 18 24 16 16 14 5 5 5 5 6 3 3 3 3 3 4 1 1 23 18 18 18 18 18 18 18 18 18 18 18 18 18 18 18 
18 18 18 18 18 18 18 18 18 18 18 18 18 18 18 18 18 30 22 16 16 16 16 16 16 14 5 5 5 5 5 15 16 20 31 18 18 18 18 18 18 18 18 18 18 18 18 18 18 18 
18 18 18 18 18 18 18 18 18 18 18 18 18 18 18 18 18 18 30 21 21 21 21 21 21 21 21 21 21 21 21 21 21 31 18 18 18 18 18 18 18 18 18 18 18 18 18 18 18 18 
18 18 18 18 18 18 18 18 18 18 18 18 18 18 18 18 18 18 18 18 18 28 18 18 18 18 18 18 18 18 18 18 18 18 18 18 18 18 18 18 18 18 18 18 18 18 18 18 18 18 
18 18 18 18 18 18 18 18 18 18 18 18 18 18 18 18 18 18 18 18 18 18 18 18 18 18 18 18 18 18 18 18 18 18 18 18 18 18 18 18 18 18 18 18 18 18 18 18 18 18 
